# Easy
print("\n ==> Level 1 <==")
board = [[0,0,7,2,8,0,0,0,0],
      [0,0,0,0,0,0,5,0,6],
      [4,1,3,0,0,6,0,8,0],
      [7,2,0,3,9,0,0,0,0],
      [3,4,0,0,0,0,8,1,0],
      [6,8,0,1,0,7,0,0,2],
      [0,0,0,6,7,4,0,2,3],
      [0,0,0,0,0,5,7,0,0],
      [1,0,6,0,2,3,0,4,0]]

# Medium
print("\n ==> Level 2 <==")
board = [[0,0,0,0,5,0,9,7,6],
      [8,0,5,1,9,0,0,3,0],
      [3,7,0,0,4,0,0,8,0],
      [0,8,0,0,0,0,0,0,9],
      [0,2,0,0,0,0,4,0,7],
      [0,9,0,0,2,6,0,1,5],
      [0,0,0,0,8,1,6,0,0],
      [9,0,0,3,0,0,0,0,0],
      [2,0,0,4,0,9,0,0,0]]

# Hard
print("\n ==> Level 3 <==")
board = [[0,3,9,0,0,0,1,2,0],
        [0,0,0,9,0,7,0,0,0],
        [8,0,0,4,0,1,0,0,6],
        [0,4,2,0,0,0,7,9,0],
        [0,0,0,0,0,0,0,0,0],
        [0,9,1,0,0,0,5,4,0],
        [5,0,0,1,0,9,0,0,3],
        [0,0,0,8,0,5,0,0,0],
        [0,1,4,0,0,0,8,7,0]]

# Very Hard
print("\n ==> Level 4 <==")
board = [[0,3,0,0,0,1,5,0,0],
      [0,0,0,5,0,0,0,8,4],
      [0,0,5,0,0,7,0,6,0],
      [0,0,0,0,0,0,0,0,0],
      [0,8,0,2,0,0,0,7,0],
      [0,0,0,8,5,0,0,0,9],
      [0,0,3,0,9,4,0,0,7],
      [0,0,4,0,0,0,0,0,8],
      [5,0,6,0,1,0,0,0,0]]

# Hardest Sudoku by telegraph
print("\n ==> Level 5 <==")
board = [
    [8,0,0,0,0,0,0,0,0],
    [0,0,3,6,0,0,0,0,0],
    [0,7,0,0,9,0,2,0,0],
    [0,5,0,0,0,7,0,0,0],
    [0,0,0,0,4,5,7,0,0],
    [0,0,0,1,0,0,0,3,0],
    [0,0,1,0,0,0,0,6,8],
    [0,0,8,5,0,0,0,1,0],
    [0,9,0,0,0,0,4,0,0]]
